####################################
#      B###      ####           ####
#  #########  #############  #######
#            #####        #   ######
######  ########## #########    ####
######  ####        ##########   ###
##      ####   ###              ####
#      #####   ##############    ###
##       ######## ##     A        ##
##    ########       ######### #####
###             ############   #####
##################           #######