####################################
#      B###      #### A         ####
#  #########  #############  #######
#            #####        #   ######
######  ########## #########    ####
######  ####        ##########   ###
##      ####   ###              ####
#      #####   ##############    ###
##       ######## ##              ##
##    ########       ######### #####
###             ############   #####
##################           #######